MODE 2
SIZE 9/11
LIMIT 0/31
COLOR LIMIT 6
STARS 1000/2500/3800
COLLECT COUNT 3/1
COLLECT ITEMS 1/2
00 00 00 10 10 10 10 10 00
00 10 10 10 10 10 10 10 10
00 10 10 10 10 10 10 10 10
10 10 10 10 10 10 10 10 10
10 10 10 10 10 10 10 10 10
10 10 10 10 10 10 10 10 10
10 10 10 10 10 10 10 10 10
10 10 10 10 10 10 10 10 10
10 10 10 10 10 10 10 10 00
10 10 10 10 10 10 10 10 00
00 10 10 10 10 10 00 00 00