MODE 3
SIZE 9/11
LIMIT 0/17
COLOR LIMIT 5
STARS 300/500/1300
COLLECT COUNT 0/0
COLLECT ITEMS 0/0
00 00 10 10 10 10 10 00 00
00 10 50 10 10 10 10 10 00
10 10 10 10 10 10 10 10 10
10 10 10 10 10 10 10 10 10
10 10 10 10 10 10 10 10 10
10 10 10 10 10 10 10 10 10
10 10 10 10 10 10 10 10 10
10 10 10 10 10 10 10 10 10
10 10 10 10 10 10 10 10 10
00 10 10 10 10 10 10 10 00
00 00 10 10 10 10 10 00 00