MODE 1
SIZE 9/9
LIMIT 1/60
COLOR LIMIT 5
STARS 1000/2500/3800
COLLECT COUNT 25/35
COLLECT ITEMS 2/3
00 00 00 10 10 10 10 10 10
00 00 10 10 10 10 10 10 10
00 10 10 10 10 10 10 10 10
10 10 10 10 10 00 10 10 10
10 10 10 10 00 10 10 10 10
10 10 10 00 10 10 10 10 10
10 10 10 10 10 10 10 10 00
10 10 10 10 10 10 10 10 00
10 10 10 10 10 10 00 00 00