MODE 3
SIZE 9/11
LIMIT 0/61
COLOR LIMIT 6
STARS 8900/12000/13900
COLLECT COUNT 0/0
COLLECT ITEMS 1/2
20 20 20 20 10 20 20 20 20
20 50 50 20 10 20 50 50 20
20 50 50 20 10 20 50 50 20
20 20 20 20 10 20 20 20 20
10 10 10 10 10 10 10 10 10
10 10 10 10 10 10 10 10 10
10 10 10 10 10 10 10 10 10
14 14 14 14 14 14 14 14 14
50 50 50 14 14 14 50 50 50
50 50 50 14 14 14 50 50 50
50 50 50 14 14 14 50 50 50