MODE 1
SIZE 9/11
LIMIT 0/11
COLOR LIMIT 4
STARS 500/1200/2100
COLLECT COUNT 15/25
COLLECT ITEMS 1/4
10 10 10 10 10 10 10 10 10
10 10 00 10 10 10 00 10 10
10 10 00 10 10 10 00 10 10
10 10 00 00 10 00 00 10 10
10 10 10 10 10 10 10 10 10
10 10 10 10 10 10 10 10 10
10 10 10 10 10 10 10 10 10
10 10 00 00 10 00 00 10 10
10 10 00 10 10 10 00 10 10
10 10 00 10 10 10 00 10 10
10 10 10 10 10 10 10 10 10