MODE 3
SIZE 9/11
LIMIT 0/17
COLOR LIMIT 5
STARS 9500/15000/21000
COLLECT COUNT 0/0
COLLECT ITEMS 1/2
10 10 10 10 23 10 10 10 10
10 10 10 10 23 10 10 10 10
10 10 10 10 23 10 10 10 10
10 10 10 10 23 10 10 10 10
10 10 10 10 23 10 10 10 10
10 10 10 10 23 10 10 10 10
10 10 10 10 23 10 10 10 10
14 14 14 14 23 14 14 14 14
50 50 14 23 23 23 14 50 50
10 50 14 23 23 23 14 50 10
10 50 14 23 23 23 14 50 10