MODE 1
SIZE 9/10
LIMIT 0/17
COLOR LIMIT 5
STARS 2300/2900/4000
COLLECT COUNT 20/25
COLLECT ITEMS 3/5
10 10 10 10 10 10 10 10 10
10 10 10 10 10 10 10 10 10
10 10 10 10 10 10 10 10 10
10 10 10 10 10 10 10 10 10
13 13 13 13 13 13 13 13 13
10 13 10 10 13 10 10 13 10
10 10 10 10 13 10 10 10 10
13 13 13 13 13 13 13 13 13
10 10 10 10 13 10 10 10 10
10 10 10 10 13 10 10 10 10