MODE 3
SIZE 9/11
LIMIT 0/28
COLOR LIMIT 5
STARS 1000/2500/3800
COLLECT COUNT 0/0
COLLECT ITEMS 1/2
10 10 10 10 10 10 10 10 10
10 10 10 10 10 10 10 10 10
10 10 10 10 10 10 10 10 10
10 10 10 10 10 10 10 10 10
14 14 14 14 14 14 14 14 14
14 14 14 14 14 14 14 14 14
10 10 10 10 10 10 10 10 10
10 17 17 17 17 17 17 17 10
10 17 20 20 20 20 20 17 10
10 17 20 20 20 20 20 17 10
10 17 17 17 17 17 17 17 10