MODE 1
SIZE 9/11
LIMIT 1/60
COLOR LIMIT 6
STARS 3500/4200/5500
COLLECT COUNT 25/30
COLLECT ITEMS 1/4
10 10 10 10 00 10 10 10 10
10 10 10 10 00 10 10 10 10
10 10 10 10 10 10 10 10 10
10 10 10 10 10 10 10 10 10
10 10 10 10 10 10 10 10 10
14 14 14 14 14 14 14 14 14
14 14 14 14 14 14 14 14 14
10 10 17 10 10 10 17 10 10
10 10 17 10 10 10 17 10 10
10 10 17 10 00 10 17 10 10
10 10 17 10 00 10 17 10 10