MODE 3
SIZE 9/11
LIMIT 0/26
COLOR LIMIT 5
STARS 5600/7000/9800
COLLECT COUNT 0/0
COLLECT ITEMS 1/2
10 10 10 10 00 10 10 10 10
10 20 20 10 10 10 20 20 10
10 20 20 10 10 10 20 20 10
10 10 10 10 10 10 10 10 10
00 10 14 14 14 14 14 10 00
00 10 14 10 10 10 14 10 00
00 10 14 10 17 10 14 10 00
00 10 14 14 14 14 14 10 00
10 10 10 10 10 10 10 10 10
10 50 50 10 10 10 50 50 10
10 50 50 10 00 10 50 50 10