MODE 1
SIZE 9/11
LIMIT 0/36
COLOR LIMIT 6
STARS 2300/4500/6550
COLLECT COUNT 25/35
COLLECT ITEMS 1/2
00 00 10 10 10 10 10 00 00
00 10 10 10 10 10 10 10 00
10 10 10 14 14 14 10 10 10
10 10 14 13 13 13 14 10 10
10 10 14 13 17 13 14 10 10
00 00 00 00 00 00 00 00 00
10 10 14 13 17 13 14 10 10
10 10 14 13 13 13 14 10 10
10 10 10 14 14 14 10 10 10
00 10 10 10 10 10 10 10 00
00 00 10 10 10 10 10 00 00