MODE 0
SIZE 9/10
LIMIT 0/25
COLOR LIMIT 5
STARS 3500/4600/5900
COLLECT COUNT 0/0
COLLECT ITEMS 1/2
00 00 10 10 10 10 10 00 00
00 10 10 10 10 10 10 10 00
10 10 10 10 10 10 10 10 10
10 10 10 10 10 10 10 10 10
10 10 10 10 10 10 10 10 10
10 10 10 10 10 10 10 10 10
13 14 13 14 13 14 13 14 13
17 13 17 13 17 13 17 13 17
10 10 10 10 10 10 10 10 10
10 10 10 10 10 10 10 10 10