MODE 2
SIZE 9/11
LIMIT 0/25
COLOR LIMIT 4
STARS 3000/4100/5600
COLLECT COUNT 2/2
COLLECT ITEMS 1/2
10 10 10 10 00 10 10 10 10
10 10 10 10 00 10 10 10 10
10 10 10 10 00 10 10 10 10
10 10 10 10 00 10 10 10 10
13 13 13 13 00 13 13 13 13
10 10 10 10 00 10 10 10 10
10 10 10 10 00 10 10 10 10
10 10 10 10 00 10 10 10 10
10 10 10 10 00 10 10 10 10
10 10 10 10 00 10 10 10 10
14 14 14 14 00 14 14 14 14