MODE 3
SIZE 9/11
LIMIT 0/35
COLOR LIMIT 6
STARS 3200/6500/7900
COLLECT COUNT 0/0
COLLECT ITEMS 1/2
10 10 10 10 10 10 10 10 10
10 50 50 10 10 10 50 50 10
10 00 00 10 10 10 00 00 10
10 20 20 10 10 10 20 20 10
10 10 10 10 10 10 10 10 10
10 10 10 10 00 10 10 10 10
10 10 10 10 10 10 10 10 10
10 10 10 10 10 10 10 10 10
14 14 14 14 14 14 14 14 14
10 10 00 00 00 00 00 10 10
10 10 20 20 20 20 20 10 10