MODE 3
SIZE 9/11
LIMIT 0/43
COLOR LIMIT 5
STARS 10000/18000/27000
COLLECT COUNT 0/0
COLLECT ITEMS 1/2
00 00 10 00 00 00 10 00 00
00 10 10 10 00 10 10 10 00
10 10 20 10 10 10 20 10 10
10 20 20 20 10 20 20 20 10
20 20 20 20 20 20 20 20 20
50 50 50 50 50 50 50 50 50
50 50 50 50 50 50 50 50 50
50 50 50 50 50 50 50 50 50
23 50 50 50 50 50 50 50 50
23 23 50 50 50 50 50 50 50
23 23 23 50 50 50 50 50 50