MODE 3
SIZE 9/11
LIMIT 0/35
COLOR LIMIT 6
STARS 3500/5300/6900
COLLECT COUNT 0/0
COLLECT ITEMS 0/0
00 10 10 10 10 10 10 10 00
10 10 10 10 10 10 10 10 10
10 20 20 20 10 20 20 20 10
10 20 20 20 20 20 20 20 10
10 20 20 20 20 20 20 20 10
10 10 20 20 20 20 20 10 10
10 20 20 20 20 20 20 20 10
10 20 20 20 20 20 20 20 10
10 20 20 20 10 20 20 20 10
10 10 10 10 10 10 10 10 10
00 10 10 10 10 10 10 10 00