MODE 3
SIZE 9/11
LIMIT 0/59
COLOR LIMIT 5
STARS 1000/2500/3800
COLLECT COUNT 0/0
COLLECT ITEMS 0/0
10 10 10 10 10 00 00 00 00
10 10 10 10 10 00 00 00 00
10 10 10 10 10 00 23 23 23
10 10 10 10 10 00 00 00 00
10 10 10 10 20 20 20 20 20
10 10 10 10 20 20 20 20 20
10 10 10 10 20 20 20 20 20
10 10 10 10 20 20 20 20 20
00 00 00 00 20 20 20 20 20
20 20 20 00 20 20 20 20 20
20 20 20 00 20 20 20 20 20