MODE 0
SIZE 9/11
LIMIT 0/30
COLOR LIMIT 4
STARS 7800/8300/10200
COLLECT COUNT 0/0
COLLECT ITEMS 1/2
10 10 10 10 00 10 10 10 10
10 10 10 10 00 10 10 10 10
10 10 10 10 10 10 10 10 10
10 10 10 10 10 10 10 10 10
10 10 10 10 10 10 10 10 10
10 10 10 10 10 10 10 10 10
00 00 00 00 00 00 00 00 00
17 17 10 14 14 14 10 17 17
17 17 10 14 10 14 10 17 17
17 17 10 14 10 14 10 17 17
17 17 10 14 14 14 10 17 17