MODE 2
SIZE 9/11
LIMIT 0/28
COLOR LIMIT 3
STARS 1000/2500/3800
COLLECT COUNT 4/4
COLLECT ITEMS 1/2
10 10 10 10 00 10 10 10 10
10 10 10 10 00 00 00 00 00
10 10 10 10 00 10 10 10 10
10 10 10 10 00 10 10 10 10
00 00 00 00 00 10 10 10 10
10 10 10 10 17 14 14 14 14
10 10 10 10 00 00 00 00 00
10 10 10 10 00 10 10 10 10
14 14 14 14 00 10 10 10 10
00 00 00 00 00 10 10 10 10
10 10 10 10 00 10 10 10 10