MODE 3
SIZE 9/9
LIMIT 0/28
COLOR LIMIT 4
STARS 5000/6900/8300
COLLECT COUNT 0/0
COLLECT ITEMS 1/2
10 10 10 10 10 10 10 10 10
10 10 10 10 10 10 10 10 10
10 10 10 10 10 10 10 10 10
00 00 00 00 00 00 00 00 00
50 50 50 50 50 50 50 50 50
00 00 00 00 00 00 00 00 00
10 10 10 10 10 10 10 10 10
10 10 14 14 14 14 14 10 10
10 10 14 10 17 10 14 10 10