MODE 3
SIZE 8/11
LIMIT 0/33
COLOR LIMIT 6
STARS 3500/5600/6800
COLLECT COUNT 0/0
COLLECT ITEMS 0/0
10 10 00 00 00 00 10 10
10 10 10 10 10 10 10 10
10 20 20 10 10 20 20 10
10 20 20 10 10 20 20 10
10 20 20 10 10 20 20 10
10 10 10 10 10 10 10 10
10 10 20 20 20 20 10 10
10 10 20 20 20 20 10 10
10 10 20 20 20 20 10 10
00 10 20 20 20 20 10 00
00 00 10 10 10 10 00 00