MODE 0
SIZE 9/11
LIMIT 1/90
COLOR LIMIT 5
STARS 3600/4800/6500
COLLECT COUNT 0/0
COLLECT ITEMS 1/2
10 10 10 10 00 10 10 10 10
10 10 10 10 00 10 10 10 10
10 13 13 10 00 10 13 13 10
10 13 13 10 00 10 13 13 10
10 10 10 10 00 10 10 10 10
10 10 10 10 00 10 10 10 10
13 13 13 13 13 13 13 13 13
10 10 10 10 13 10 10 10 10
14 14 14 10 13 10 14 14 14
10 10 14 10 13 10 14 10 10
17 10 14 10 13 10 14 10 17