MODE 0
SIZE 9/11
LIMIT 0/35
COLOR LIMIT 6
STARS 3500/4800/6200
COLLECT COUNT 0/0
COLLECT ITEMS 1/2
10 10 10 10 10 10 10 10 10
10 14 10 10 10 10 10 14 10
10 13 14 10 10 10 14 13 10
10 14 13 14 10 14 13 14 10
10 10 14 13 14 13 14 10 10
10 10 10 14 10 14 10 10 10
10 10 10 10 10 10 10 10 10
10 10 10 10 10 10 10 10 10
14 10 10 10 10 10 10 10 14
13 14 10 10 10 10 10 14 13
13 13 14 10 10 10 14 13 13