MODE 3
SIZE 9/11
LIMIT 0/38
COLOR LIMIT 5
STARS 2500/3600/7800
COLLECT COUNT 0/0
COLLECT ITEMS 1/2
10 10 10 10 00 10 10 10 10
10 10 10 10 10 10 10 10 10
10 10 10 10 10 10 10 10 10
10 10 10 10 10 10 10 10 10
14 14 14 14 14 14 14 14 14
00 10 10 10 14 10 10 10 00
10 10 10 10 14 10 10 10 10
10 10 10 23 23 23 10 10 10
10 10 23 14 23 14 23 10 10
10 23 14 23 23 23 14 23 10
23 14 23 23 23 23 23 14 23