MODE 2
SIZE 9/11
LIMIT 0/28
COLOR LIMIT 4
STARS 2500/5300/8600
COLLECT COUNT 4/4
COLLECT ITEMS 1/2
10 10 00 00 00 00 00 10 10
10 10 10 00 00 00 10 10 10
10 10 10 10 00 10 10 10 10
10 10 10 10 14 10 10 10 10
10 10 10 10 14 10 10 10 10
10 10 10 10 14 10 10 10 10
10 10 14 14 14 14 14 10 10
10 10 14 14 14 14 14 10 10
14 14 14 14 14 14 14 14 14
10 10 10 10 10 10 10 10 10
13 13 13 13 13 13 13 13 13