MODE 3
SIZE 9/11
LIMIT 0/15
COLOR LIMIT 4
STARS 2100/3600/4800
COLLECT COUNT 0/0
COLLECT ITEMS 1/2
10 10 10 20 20 20 10 10 10
10 10 10 20 00 20 10 10 10
10 10 10 20 20 20 10 10 10
10 10 10 20 20 20 10 10 10
00 00 00 20 20 20 00 00 00
10 10 10 10 10 10 10 10 10
10 10 10 10 10 10 10 10 10
00 00 00 50 50 50 00 00 00
10 10 10 50 50 50 10 10 10
10 10 10 50 50 50 10 10 10
17 10 10 50 50 50 10 10 17