MODE 2
SIZE 9/10
LIMIT 0/41
COLOR LIMIT 5
STARS 2300/5600/7800
COLLECT COUNT 2/1
COLLECT ITEMS 1/2
10 10 10 10 10 10 10 10 10
10 10 10 10 10 10 10 10 10
10 10 10 10 10 10 10 10 10
10 10 10 10 10 10 10 10 10
10 10 10 10 10 10 10 10 10
10 10 10 10 10 10 10 10 10
10 10 10 10 10 10 10 10 10
10 10 10 10 10 10 10 10 10
14 00 14 00 14 00 14 00 14
13 10 13 10 13 10 13 10 13