MODE 1
SIZE 9/10
LIMIT 1/60
COLOR LIMIT 5
STARS 2300/5300/8600
COLLECT COUNT 45/45
COLLECT ITEMS 2/5
10 10 10 10 10 10 10 10 10
10 13 10 13 10 13 10 13 10
10 10 10 10 10 10 10 10 10
10 10 10 10 10 10 10 10 10
00 10 10 10 10 10 10 10 00
00 10 10 10 10 10 10 10 00
10 10 10 10 10 10 10 10 10
10 10 10 10 10 10 10 10 10
17 17 17 17 17 17 17 17 17
17 17 17 17 17 17 17 17 17