MODE 0
SIZE 9/11
LIMIT 0/15
COLOR LIMIT 4
STARS 8200/10400/13600
COLLECT COUNT 0/0
COLLECT ITEMS 1/2
10 10 10 10 10 10 10 10 10
10 10 10 10 10 10 10 10 10
10 10 10 10 10 10 10 10 10
10 10 10 10 10 10 10 10 10
14 10 10 10 10 10 10 10 14
14 14 10 10 10 10 10 14 14
14 14 14 14 14 14 14 14 14
14 13 14 14 14 14 14 13 14
14 14 14 13 14 13 14 14 14
00 14 14 14 14 14 14 14 00
00 00 14 14 14 14 14 00 00