MODE 0
SIZE 9/11
LIMIT 0/25
COLOR LIMIT 5
STARS 1500/1900/3200
COLLECT COUNT 0/0
COLLECT ITEMS 1/2
10 00 00 10 10 10 00 00 10
00 10 00 10 10 10 00 10 00
00 00 10 10 10 10 10 00 00
10 10 10 10 10 10 10 10 10
10 10 10 10 10 10 10 10 10
10 10 10 00 00 00 10 10 10
10 10 10 00 10 00 10 10 10
10 10 10 00 10 00 10 10 10
00 10 10 10 10 10 10 10 00
00 00 10 10 10 10 10 00 00
00 00 00 10 10 10 00 00 00