MODE 1
SIZE 9/11
LIMIT 0/29
COLOR LIMIT 5
STARS 2600/5600/7500
COLLECT COUNT 30/30
COLLECT ITEMS 1/4
10 10 10 10 10 10 10 10 10
10 13 10 13 13 13 10 13 10
10 13 10 10 10 10 10 13 10
10 13 10 10 10 10 10 13 10
10 13 10 13 13 13 10 13 10
10 10 10 10 10 10 10 10 10
10 13 10 13 13 13 10 13 10
10 13 10 10 10 10 10 13 10
10 13 10 10 10 10 10 13 10
10 13 10 13 13 13 10 13 10
10 10 10 10 10 10 10 10 10