MODE 3
SIZE 9/11
LIMIT 0/36
COLOR LIMIT 5
STARS 2100/3500/6900
COLLECT COUNT 0/0
COLLECT ITEMS 1/2
00 10 10 14 10 14 10 10 00
10 10 10 10 14 10 10 10 10
10 10 10 10 14 10 10 10 10
10 10 10 23 14 23 10 10 10
14 10 10 23 14 23 10 10 14
10 14 14 23 14 23 14 14 10
14 10 10 23 14 23 10 10 14
10 10 10 23 14 23 10 10 10
10 10 10 10 14 10 10 10 10
10 10 10 10 14 10 10 10 10
00 10 10 14 10 14 10 10 00