MODE 3
SIZE 9/5
LIMIT 0/6
COLOR LIMIT 6
STARS 100/200/300
COLLECT COUNT 0/0
COLLECT ITEMS 0/0
00 10 10 10 10 10 10 10 10
00 70 00 13 13 13 10 10 10
00 10 10 10 10 10 14 10 10
00 10 10 10 10 10 10 10 10
00 10 10 10 10 10 10 10 10