MODE 1
SIZE 9/11
LIMIT 0/19
COLOR LIMIT 5
STARS 1000/2500/3800
COLLECT COUNT 20/25
COLLECT ITEMS 1/2
10 00 10 10 00 10 10 00 10
10 00 10 10 00 10 10 00 10
10 10 10 10 10 10 10 10 10
10 10 10 10 10 10 10 10 10
10 10 10 10 10 10 10 10 10
10 10 10 10 10 10 10 10 10
10 10 10 10 10 10 10 10 10
10 10 10 10 10 10 10 10 10
10 10 10 10 10 10 10 10 10
00 10 10 10 10 10 10 10 00
00 00 10 10 10 10 10 00 00