MODE 3
SIZE 9/11
LIMIT 0/48
COLOR LIMIT 5
STARS 12000/14000/18000
COLLECT COUNT 0/0
COLLECT ITEMS 1/2
10 10 10 10 10 10 10 10 10
10 10 10 10 10 10 10 10 10
00 00 00 10 10 10 00 00 00
10 10 10 10 10 10 10 10 10
10 10 10 10 10 10 10 10 10
10 10 10 10 10 10 10 10 10
14 23 14 23 14 23 14 23 14
23 14 23 14 23 14 23 14 23
14 23 14 23 14 23 14 23 14
23 14 23 14 23 14 23 14 23
14 23 14 23 14 23 14 23 14