MODE 2
SIZE 9/9
LIMIT 0/40
COLOR LIMIT 5
STARS 4200/5600/8900
COLLECT COUNT 2/2
COLLECT ITEMS 1/2
10 10 10 10 10 10 10 10 10
10 10 10 10 10 10 10 10 10
10 10 10 10 00 10 10 10 10
10 10 10 10 00 10 10 10 10
10 10 10 10 10 10 10 10 10
10 10 10 10 10 10 10 10 10
10 10 10 10 10 10 10 10 10
10 10 10 10 10 10 10 10 10
13 13 13 13 13 13 13 13 13